year,week,home_team,away_team,home_score,away_score,home_win,point_diff,total_points,home_win_streak,game_number
2018,1,49ers,Bears,13,20,0,-7,33,0.0,1
2018,1,Cowboys,Packers,22,40,0,-18,62,0.0,1
2018,1,Patriots,Eagles,23,30,0,-7,53,0.0,1
2018,1,Patriots,Bills,11,32,0,-21,43,0.0,2
2018,1,49ers,Patriots,35,41,0,-6,76,0.0,2
2018,1,Eagles,Bears,18,20,0,-2,38,0.0,1
2018,1,Patriots,Ravens,42,31,1,11,73,1.0,3
2018,1,Chiefs,49ers,14,10,1,4,24,1.0,1
2018,2,Patriots,Ravens,19,45,0,-26,64,1.0,4
2018,2,Packers,Cowboys,13,24,0,-11,37,0.0,1
2018,2,Packers,Patriots,28,36,0,-8,64,0.0,2
2018,2,Packers,Bills,18,20,0,-2,38,0.0,3
2018,2,Chiefs,Bears,14,28,0,-14,42,1.0,2
2018,2,49ers,Bills,35,38,0,-3,73,0.0,3
2018,2,Ravens,Chiefs,29,43,0,-14,72,0.0,1
2018,2,Eagles,Packers,35,42,0,-7,77,0.0,2
2018,3,49ers,Chiefs,41,31,1,10,72,1.0,4
2018,3,Bears,Packers,19,37,0,-18,56,0.0,1
2018,3,Bears,49ers,21,29,0,-8,50,0.0,2
2018,3,Patriots,Eagles,16,35,0,-19,51,1.0,5
2018,3,Steelers,Cowboys,13,23,0,-10,36,0.0,1
2018,3,Eagles,Chiefs,35,44,0,-9,79,0.0,3
2018,3,Bills,Packers,39,42,0,-3,81,0.0,1
2018,3,Eagles,Packers,34,18,1,16,52,1.0,4
2018,4,Bills,Chiefs,15,43,0,-28,58,0.0,2
2018,4,Chiefs,Eagles,29,44,0,-15,73,1.0,3
2018,4,Cowboys,Steelers,34,43,0,-9,77,0.0,2
2018,4,Ravens,Cowboys,34,37,0,-3,71,0.0,2
2018,4,Chiefs,Bills,14,28,0,-14,42,0.0,4
2018,4,Bills,Packers,18,16,1,2,34,1.0,3
2018,4,Eagles,Chiefs,28,35,0,-7,63,1.0,5
2018,4,Chiefs,Steelers,41,25,1,16,66,1.0,5
2018,5,Bears,Packers,20,30,0,-10,50,0.0,3
2018,5,Bills,Chiefs,37,33,1,4,70,2.0,4
2018,5,Ravens,Chiefs,43,10,1,33,53,1.0,3
2018,5,Eagles,Bills,22,13,1,9,35,2.0,6
2018,5,Bills,Eagles,39,35,1,4,74,3.0,5
2018,5,Chiefs,Cowboys,24,23,1,1,47,2.0,6
2018,5,Steelers,Eagles,25,31,0,-6,56,0.0,2
2018,5,Bills,Patriots,18,27,0,-9,45,2.0,6
2018,6,Ravens,49ers,34,29,1,5,63,2.0,4
2018,6,Bills,Eagles,28,18,1,10,46,2.0,7
2018,6,Bears,Bills,17,30,0,-13,47,0.0,4
2018,6,49ers,Bears,45,10,1,35,55,2.0,5
2018,6,Steelers,Cowboys,21,36,0,-15,57,0.0,3
2018,6,Bears,49ers,34,42,0,-8,76,0.0,5
2018,6,Packers,Chiefs,37,34,1,3,71,1.0,4
2018,6,Eagles,Steelers,26,19,1,7,45,2.0,7
2018,7,Bills,Cowboys,35,18,1,17,53,2.0,8
2018,7,Steelers,Patriots,26,13,1,13,39,1.0,4
2018,7,Packers,Cowboys,26,40,0,-14,66,1.0,5
2018,7,Patriots,Packers,37,41,0,-4,78,0.0,6
2018,7,Chiefs,Steelers,21,35,0,-14,56,2.0,7
2018,7,Bills,Ravens,40,42,0,-2,82,2.0,9
2018,7,Eagles,Packers,18,25,0,-7,43,2.0,8
2018,7,Bears,Chiefs,37,44,0,-7,81,0.0,6
2018,8,Packers,Cowboys,12,18,0,-6,30,1.0,6
2018,8,Bears,Steelers,37,45,0,-8,82,0.0,7
2018,8,Packers,49ers,35,23,1,12,58,1.0,7
2018,8,Patriots,Steelers,20,45,0,-25,65,0.0,7
2018,8,Patriots,Chiefs,26,11,1,15,37,1.0,8
2018,8,Bears,Packers,41,18,1,23,59,1.0,8
2018,8,Steelers,Bears,34,17,1,17,51,2.0,5
2018,8,Steelers,Chiefs,36,44,0,-8,80,2.0,6
2018,9,Patriots,Steelers,19,23,0,-4,42,1.0,9
2018,9,Cowboys,Bills,19,18,1,1,37,1.0,3
2018,9,Bears,Ravens,16,14,1,2,30,2.0,9
2018,9,49ers,Bears,10,41,0,-31,51,2.0,6
2018,9,Steelers,Eagles,19,23,0,-4,42,1.0,7
2018,9,Eagles,Ravens,40,24,1,16,64,2.0,9
2018,9,Steelers,Cowboys,29,28,1,1,57,1.0,8
2018,9,Cowboys,Chiefs,39,24,1,15,63,2.0,4
2018,10,Eagles,Packers,41,15,1,26,56,2.0,10
2018,10,Eagles,Ravens,41,14,1,27,55,3.0,11
2018,10,Bills,Chiefs,37,13,1,24,50,2.0,10
2018,10,Packers,Bears,32,20,1,12,52,2.0,8
2018,10,Bills,Bears,28,14,1,14,42,2.0,11
2018,10,Bears,Cowboys,29,21,1,8,50,3.0,10
2018,10,Chiefs,Cowboys,16,27,0,-11,43,1.0,8
2018,10,Bills,Patriots,45,17,1,28,62,3.0,12
2018,11,Patriots,Cowboys,13,32,0,-19,45,1.0,10
2018,11,Cowboys,Patriots,29,42,0,-13,71,2.0,5
2018,11,Chiefs,Cowboys,32,20,1,12,52,1.0,9
2018,11,49ers,Patriots,30,33,0,-3,63,1.0,7
2018,11,Patriots,49ers,18,13,1,5,31,1.0,11
2018,11,Ravens,Patriots,20,41,0,-21,61,2.0,5
2018,11,Packers,Steelers,31,41,0,-10,72,2.0,9
2018,11,Cowboys,Eagles,15,19,0,-4,34,1.0,6
2018,12,Chiefs,Steelers,16,38,0,-22,54,1.0,10
2018,12,Patriots,Ravens,18,10,1,8,28,2.0,12
2018,12,49ers,Ravens,22,22,0,0,44,0.0,8
2018,12,Steelers,Packers,36,19,1,17,55,2.0,9
2018,12,Patriots,Bears,30,37,0,-7,67,2.0,13
2018,12,Ravens,Steelers,24,39,0,-15,63,1.0,6
2018,12,49ers,Cowboys,33,45,0,-12,78,0.0,9
2018,12,Ravens,Bills,26,43,0,-17,69,0.0,7
2018,13,Steelers,Eagles,35,42,0,-7,77,2.0,10
2018,13,Bills,Cowboys,11,23,0,-12,34,2.0,13
2018,13,Bears,Ravens,24,20,1,4,44,3.0,11
2018,13,49ers,Ravens,44,34,1,10,78,1.0,10
2018,13,Bears,Cowboys,21,16,1,5,37,3.0,12
2018,13,Packers,49ers,32,23,1,9,55,2.0,10
2018,13,Chiefs,Patriots,31,25,1,6,56,2.0,11
2018,13,Eagles,Chiefs,12,11,1,1,23,3.0,12
2018,14,Steelers,Chiefs,34,28,1,6,62,2.0,11
2018,14,Bills,49ers,14,23,0,-9,37,1.0,14
2018,14,Chiefs,Steelers,12,40,0,-28,52,1.0,12
2018,14,Chiefs,Ravens,13,35,0,-22,48,1.0,13
2018,14,Chiefs,Ravens,18,22,0,-4,40,0.0,14
2018,14,Eagles,49ers,27,18,1,9,45,3.0,13
2018,14,Chiefs,Steelers,19,28,0,-9,47,0.0,15
2018,14,Chiefs,Cowboys,12,44,0,-32,56,0.0,16
2018,15,Bills,Patriots,40,38,1,2,78,1.0,15
2018,15,49ers,Ravens,39,36,1,3,75,2.0,11
2018,15,Patriots,Chiefs,27,31,0,-4,58,1.0,14
2018,15,Bills,Packers,39,38,1,1,77,2.0,16
2018,15,Cowboys,49ers,17,25,0,-8,42,0.0,7
2018,15,Patriots,Bears,23,29,0,-6,52,0.0,15
2018,15,Eagles,Cowboys,18,11,1,7,29,3.0,14
2018,15,Packers,Steelers,16,26,0,-10,42,1.0,11
2018,16,Ravens,Steelers,40,37,1,3,77,1.0,8
2018,16,Bears,Cowboys,17,39,0,-22,56,2.0,13
2018,16,Cowboys,Eagles,38,35,1,3,73,1.0,8
2018,16,Cowboys,Eagles,45,20,1,25,65,2.0,9
2018,16,Chiefs,49ers,13,25,0,-12,38,0.0,17
2018,16,Patriots,Bills,24,30,0,-6,54,0.0,16
2018,16,Bills,49ers,41,40,1,1,81,3.0,17
2018,16,Bills,Chiefs,36,21,1,15,57,3.0,18
2018,17,Bills,Bears,40,40,0,0,80,2.0,19
2018,17,Chiefs,Cowboys,45,39,1,6,84,1.0,18
2018,17,Steelers,Ravens,12,34,0,-22,46,1.0,12
2018,17,Patriots,Bears,45,22,1,23,67,1.0,17
2018,17,Ravens,Packers,39,38,1,1,77,2.0,9
2018,17,49ers,Bears,22,30,0,-8,52,2.0,12
2018,17,Bears,Steelers,32,38,0,-6,70,1.0,14
2018,17,Patriots,Cowboys,25,22,1,3,47,2.0,18
2019,1,Cowboys,Chiefs,15,16,0,-1,31,2.0,10
2019,1,Cowboys,Ravens,24,26,0,-2,50,1.0,11
2019,1,Bears,Bills,34,30,1,4,64,1.0,15
2019,1,Chiefs,Ravens,18,44,0,-26,62,1.0,19
2019,1,49ers,Eagles,19,45,0,-26,64,1.0,13
2019,1,Patriots,Bears,17,29,0,-12,46,2.0,19
2019,1,Steelers,49ers,11,38,0,-27,49,1.0,13
2019,1,Ravens,Eagles,27,40,0,-13,67,2.0,10
2019,2,Chiefs,Bills,23,14,1,9,37,2.0,20
2019,2,Chiefs,Bills,45,28,1,17,73,2.0,21
2019,2,Bills,Chiefs,16,31,0,-15,47,1.0,20
2019,2,Cowboys,Ravens,23,24,0,-1,47,0.0,12
2019,2,Ravens,Cowboys,31,33,0,-2,64,1.0,11
2019,2,Patriots,Bills,34,33,1,1,67,2.0,20
2019,2,Eagles,Patriots,28,13,1,15,41,3.0,15
2019,2,Steelers,49ers,11,42,0,-31,53,0.0,14
2019,3,Steelers,Eagles,28,29,0,-1,57,0.0,15
2019,3,Steelers,Patriots,45,35,1,10,80,1.0,16
2019,3,Cowboys,Chiefs,34,35,0,-1,69,0.0,13
2019,3,Patriots,Chiefs,36,11,1,25,47,2.0,21
2019,3,Packers,Bills,22,24,0,-2,46,1.0,12
2019,3,49ers,Bills,40,37,1,3,77,1.0,14
2019,3,Bears,49ers,17,23,0,-6,40,1.0,16
2019,3,Bills,Bears,14,30,0,-16,44,0.0,21
2019,4,Chiefs,Steelers,15,38,0,-23,53,2.0,22
2019,4,Bears,Eagles,28,35,0,-7,63,1.0,17
2019,4,Ravens,Eagles,32,30,1,2,62,1.0,12
2019,4,Cowboys,Bills,27,40,0,-13,67,0.0,14
2019,4,Ravens,Patriots,19,26,0,-7,45,1.0,13
2019,4,49ers,Eagles,41,44,0,-3,85,1.0,15
2019,4,Bears,Ravens,40,25,1,15,65,1.0,18
2019,4,Bears,Patriots,41,28,1,13,69,2.0,19
2019,5,49ers,Ravens,39,24,1,15,63,2.0,16
2019,5,Steelers,Eagles,29,27,1,2,56,2.0,17
2019,5,Chiefs,Cowboys,35,17,1,18,52,2.0,23
2019,5,Ravens,Bills,20,40,0,-20,60,1.0,14
2019,5,Bears,Chiefs,42,44,0,-2,86,2.0,20
2019,5,Cowboys,49ers,39,44,0,-5,83,0.0,15
2019,5,Eagles,Chiefs,30,21,1,9,51,3.0,16
2019,5,Chiefs,Bears,17,30,0,-13,47,1.0,24
2019,6,Cowboys,Packers,44,43,1,1,87,1.0,16
2019,6,Patriots,Chiefs,26,23,1,3,49,3.0,22
2019,6,Packers,Steelers,34,25,1,9,59,1.0,13
2019,6,Steelers,Eagles,25,42,0,-17,67,2.0,18
2019,6,Ravens,Bears,19,42,0,-23,61,0.0,15
2019,6,Eagles,Steelers,27,15,1,12,42,3.0,17
2019,6,Packers,49ers,19,26,0,-7,45,1.0,14
2019,6,Cowboys,49ers,30,35,0,-5,65,1.0,17
2019,7,Eagles,Bills,40,25,1,15,65,3.0,18
2019,7,Bills,Ravens,14,12,1,2,26,1.0,22
2019,7,Chiefs,Cowboys,43,23,1,20,66,2.0,25
2019,7,49ers,Bears,27,34,0,-7,61,1.0,17
2019,7,Steelers,Cowboys,21,20,1,1,41,2.0,19
2019,7,Cowboys,Eagles,37,14,1,23,51,2.0,18
2019,7,Eagles,Chiefs,27,20,1,7,47,3.0,19
2019,7,Steelers,49ers,33,22,1,11,55,2.0,20
2019,8,Chiefs,Bears,19,12,1,7,31,2.0,26
2019,8,Steelers,Patriots,28,15,1,13,43,3.0,21
2019,8,Bears,Ravens,21,45,0,-24,66,1.0,21
2019,8,Eagles,Bills,44,22,1,22,66,3.0,20
2019,8,Bears,Steelers,38,15,1,23,53,1.0,22
2019,8,Chiefs,Cowboys,10,37,0,-27,47,2.0,27
2019,8,Packers,Bears,33,39,0,-6,72,1.0,15
2019,8,Patriots,Steelers,28,33,0,-5,61,2.0,23
2019,9,Bills,Bears,39,39,0,0,78,1.0,23
2019,9,Eagles,Packers,35,20,1,15,55,3.0,21
2019,9,Chiefs,Bears,44,12,1,32,56,2.0,28
2019,9,Steelers,Chiefs,35,12,1,23,47,3.0,22
2019,9,Patriots,Eagles,11,35,0,-24,46,1.0,24
2019,9,Chiefs,Eagles,24,17,1,7,41,2.0,29
2019,9,Cowboys,Ravens,45,30,1,15,75,2.0,19
2019,9,Ravens,Bills,22,20,1,2,42,1.0,16
2019,10,Cowboys,Chiefs,43,21,1,22,64,3.0,20
2019,10,Chiefs,Eagles,31,24,1,7,55,3.0,30
2019,10,49ers,Chiefs,30,29,1,1,59,2.0,18
2019,10,Ravens,Bills,45,17,1,28,62,2.0,17
2019,10,Ravens,Cowboys,45,45,0,0,90,2.0,18
2019,10,Eagles,Cowboys,35,37,0,-2,72,2.0,22
2019,10,Steelers,Cowboys,18,43,0,-25,61,2.0,23
2019,10,Bears,Bills,39,22,1,17,61,2.0,23
2019,11,Ravens,Bears,28,19,1,9,47,2.0,19
2019,11,Steelers,Bears,39,28,1,11,67,2.0,24
2019,11,Patriots,Bills,39,40,0,-1,79,0.0,25
2019,11,Steelers,Bills,23,37,0,-14,60,1.0,25
2019,11,Packers,Bills,31,34,0,-3,65,0.0,16
2019,11,Packers,Ravens,44,30,1,14,74,1.0,17
2019,11,Chiefs,Cowboys,32,39,0,-7,71,2.0,31
2019,11,Bills,Chiefs,38,11,1,27,49,2.0,24
2019,12,Ravens,Cowboys,30,22,1,8,52,2.0,20
2019,12,Packers,Bears,14,14,0,0,28,1.0,18
2019,12,Ravens,Steelers,41,30,1,11,71,3.0,21
2019,12,49ers,Eagles,13,13,0,0,26,1.0,19
2019,12,Bears,Patriots,14,27,0,-13,41,2.0,24
2019,12,49ers,Cowboys,30,42,0,-12,72,1.0,20
2019,12,Ravens,Chiefs,33,31,1,2,64,3.0,22
2019,12,Bears,Eagles,30,42,0,-12,72,1.0,25
2019,13,Packers,Steelers,40,12,1,28,52,2.0,19
2019,13,Eagles,Cowboys,41,15,1,26,56,2.0,23
2019,13,Packers,Steelers,33,24,1,9,57,2.0,20
2019,13,Steelers,Bears,15,19,0,-4,34,1.0,26
2019,13,Eagles,Packers,22,14,1,8,36,2.0,24
2019,13,Ravens,Bears,43,33,1,10,76,3.0,23
2019,13,49ers,Ravens,31,42,0,-11,73,0.0,21
2019,13,Eagles,Packers,18,22,0,-4,40,2.0,25
2019,14,Cowboys,Ravens,33,14,1,19,47,3.0,21
2019,14,Ravens,Eagles,38,36,1,2,74,3.0,24
2019,14,Bears,Eagles,22,41,0,-19,63,0.0,26
2019,14,Patriots,Chiefs,27,33,0,-6,60,0.0,26
2019,14,Bears,49ers,40,19,1,21,59,1.0,27
2019,14,Chiefs,Steelers,21,25,0,-4,46,1.0,32
2019,14,Steelers,Eagles,22,15,1,7,37,1.0,27
2019,14,Patriots,Packers,43,25,1,18,68,1.0,27
2019,15,Cowboys,Ravens,24,36,0,-12,60,2.0,22
2019,15,Steelers,Cowboys,23,41,0,-18,64,1.0,28
2019,15,Cowboys,Ravens,37,11,1,26,48,2.0,23
2019,15,Ravens,Eagles,38,27,1,11,65,3.0,25
2019,15,Chiefs,Bears,39,42,0,-3,81,0.0,33
2019,15,Chiefs,Packers,30,22,1,8,52,1.0,34
2019,15,Patriots,Cowboys,29,43,0,-14,72,1.0,28
2019,15,49ers,Ravens,42,23,1,19,65,1.0,22
2019,16,Patriots,Chiefs,18,21,0,-3,39,1.0,29
2019,16,Ravens,Chiefs,19,15,1,4,34,3.0,26
2019,16,Chiefs,Cowboys,21,19,1,2,40,2.0,35
2019,16,Patriots,Eagles,34,43,0,-9,77,0.0,30
2019,16,Ravens,Bears,23,30,0,-7,53,2.0,27
2019,16,Patriots,Bears,37,19,1,18,56,1.0,31
2019,16,Bills,Ravens,17,41,0,-24,58,1.0,25
2019,16,Bills,Packers,12,40,0,-28,52,1.0,26
2019,17,Cowboys,Patriots,29,37,0,-8,66,1.0,24
2019,17,Bills,Ravens,40,36,1,4,76,1.0,27
2019,17,Patriots,Bills,24,45,0,-21,69,1.0,32
2019,17,Patriots,Chiefs,19,15,1,4,34,2.0,33
2019,17,Packers,Bears,41,44,0,-3,85,2.0,21
2019,17,Steelers,Packers,24,11,1,13,35,2.0,29
2019,17,Patriots,Bills,32,23,1,9,55,2.0,34
2019,17,Patriots,Bears,26,13,1,13,39,3.0,35
2020,1,Bills,49ers,30,44,0,-14,74,1.0,28
2020,1,Packers,Steelers,16,24,0,-8,40,1.0,22
2020,1,Packers,Patriots,19,17,1,2,36,1.0,23
2020,1,Bears,Packers,42,45,0,-3,87,1.0,28
2020,1,Cowboys,Ravens,11,40,0,-29,51,1.0,25
2020,1,Patriots,Chiefs,25,42,0,-17,67,2.0,36
2020,1,Steelers,Chiefs,27,41,0,-14,68,1.0,30
2020,1,Bills,Ravens,20,23,0,-3,43,1.0,29
2020,2,Eagles,Packers,22,28,0,-6,50,1.0,26
2020,2,Ravens,Packers,45,22,1,23,67,2.0,28
2020,2,Eagles,Packers,33,40,0,-7,73,0.0,27
2020,2,Bills,Chiefs,21,38,0,-17,59,0.0,30
2020,2,Eagles,Steelers,33,18,1,15,51,1.0,28
2020,2,49ers,Ravens,15,18,0,-3,33,1.0,23
2020,2,Bills,Patriots,19,44,0,-25,63,0.0,31
2020,2,Packers,Patriots,21,39,0,-18,60,1.0,24
2020,3,Chiefs,Eagles,26,14,1,12,40,3.0,36
2020,3,Eagles,Steelers,22,33,0,-11,55,1.0,29
2020,3,Chiefs,Cowboys,13,14,0,-1,27,2.0,37
2020,3,Cowboys,Bills,10,25,0,-15,35,0.0,26
2020,3,Bears,Bills,26,16,1,10,42,2.0,29
2020,3,Patriots,Bills,39,45,0,-6,84,1.0,37
2020,3,Chiefs,Bears,30,36,0,-6,66,1.0,38
2020,3,Bears,49ers,10,23,0,-13,33,1.0,30
2020,4,Bills,Chiefs,44,15,1,29,59,1.0,32
2020,4,Bears,Cowboys,11,11,0,0,22,1.0,31
2020,4,Bills,Patriots,33,24,1,9,57,2.0,33
2020,4,Chiefs,Ravens,29,27,1,2,56,1.0,39
2020,4,Packers,Chiefs,34,12,1,22,46,2.0,25
2020,4,Cowboys,Ravens,24,19,1,5,43,1.0,27
2020,4,Eagles,Chiefs,16,26,0,-10,42,1.0,30
2020,4,Chiefs,Patriots,26,21,1,5,47,2.0,40
2020,5,Ravens,Chiefs,40,29,1,11,69,2.0,29
2020,5,Steelers,49ers,23,42,0,-19,65,1.0,31
2020,5,Cowboys,Ravens,45,43,1,2,88,2.0,28
2020,5,Chiefs,49ers,33,44,0,-11,77,2.0,41
2020,5,Patriots,Chiefs,31,33,0,-2,64,0.0,38
2020,5,Chiefs,Steelers,34,31,1,3,65,2.0,42
2020,5,Eagles,Bears,24,43,0,-19,67,0.0,31
2020,5,Packers,Patriots,36,19,1,17,55,2.0,26
2020,6,49ers,Steelers,36,42,0,-6,78,1.0,24
2020,6,49ers,Packers,15,25,0,-10,40,0.0,25
2020,6,Chiefs,Cowboys,37,38,0,-1,75,1.0,43
2020,6,49ers,Eagles,23,32,0,-9,55,0.0,26
2020,6,Bears,Packers,31,14,1,17,45,1.0,32
2020,6,Steelers,49ers,10,24,0,-14,34,0.0,32
2020,6,Bears,Packers,45,41,1,4,86,2.0,33
2020,6,Bills,Steelers,14,15,0,-1,29,2.0,34
2020,7,Steelers,Bills,36,45,0,-9,81,0.0,33
2020,7,Cowboys,Bears,22,10,1,12,32,3.0,29
2020,7,Bears,Ravens,38,25,1,13,63,3.0,34
2020,7,Patriots,49ers,20,11,1,9,31,1.0,39
2020,7,Ravens,Steelers,24,29,0,-5,53,2.0,30
2020,7,Packers,Bills,32,11,1,21,43,3.0,27
2020,7,Ravens,Chiefs,22,43,0,-21,65,1.0,31
2020,7,Cowboys,Patriots,29,44,0,-15,73,2.0,30
2020,8,Cowboys,Steelers,24,23,1,1,47,2.0,31
2020,8,Eagles,Bears,27,29,0,-2,56,0.0,32
2020,8,Chiefs,Patriots,13,38,0,-25,51,1.0,44
2020,8,Ravens,Steelers,20,13,1,7,33,1.0,32
2020,8,49ers,Bills,37,39,0,-2,76,0.0,27
2020,8,Chiefs,Patriots,10,26,0,-16,36,0.0,45
2020,8,Bills,49ers,23,11,1,12,34,2.0,35
2020,8,Patriots,Bills,35,30,1,5,65,2.0,40
2020,9,Chiefs,Steelers,41,26,1,15,67,1.0,46
2020,9,Ravens,Chiefs,18,37,0,-19,55,1.0,33
2020,9,Bears,Packers,32,30,1,2,62,3.0,35
2020,9,49ers,Ravens,12,28,0,-16,40,0.0,28
2020,9,Steelers,Bills,41,32,1,9,73,1.0,34
2020,9,Bears,Patriots,44,33,1,11,77,3.0,36
2020,9,Ravens,Bears,13,21,0,-8,34,1.0,34
2020,9,49ers,Bears,36,17,1,19,53,1.0,29
2020,10,Chiefs,Steelers,13,12,1,1,25,2.0,47
2020,10,Ravens,Bears,30,32,0,-2,62,0.0,35
2020,10,Chiefs,Bills,43,30,1,13,73,3.0,48
2020,10,49ers,Eagles,34,33,1,1,67,2.0,30
2020,10,Patriots,Bears,37,10,1,27,47,3.0,41
2020,10,Steelers,Packers,14,38,0,-24,52,1.0,35
2020,10,Cowboys,49ers,13,41,0,-28,54,1.0,32
2020,10,Ravens,Packers,42,45,0,-3,87,0.0,36
2020,11,Patriots,Ravens,40,13,1,27,53,3.0,42
2020,11,Steelers,Bears,39,20,1,19,59,2.0,36
2020,11,Patriots,Bears,30,34,0,-4,64,2.0,43
2020,11,Patriots,Packers,32,31,1,1,63,2.0,44
2020,11,Chiefs,Steelers,30,24,1,6,54,3.0,49
2020,11,Patriots,Chiefs,42,29,1,13,71,2.0,45
2020,11,49ers,Ravens,15,23,0,-8,38,2.0,31
2020,11,Packers,Bears,25,13,1,12,38,3.0,28
2020,12,Patriots,49ers,12,38,0,-26,50,2.0,46
2020,12,Steelers,Eagles,20,40,0,-20,60,1.0,37
2020,12,Cowboys,Chiefs,23,20,1,3,43,2.0,33
2020,12,49ers,Patriots,31,22,1,9,53,2.0,32
2020,12,Bills,Bears,40,41,0,-1,81,1.0,36
2020,12,Chiefs,Patriots,29,35,0,-6,64,2.0,50
2020,12,Eagles,Bills,29,13,1,16,42,1.0,33
2020,12,Cowboys,Bears,38,38,0,0,76,1.0,34
2020,13,Eagles,Steelers,37,14,1,23,51,2.0,34
2020,13,Chiefs,Patriots,38,45,0,-7,83,1.0,51
2020,13,Patriots,Chiefs,41,11,1,30,52,2.0,47
2020,13,Ravens,Bills,22,21,1,1,43,1.0,37
2020,13,49ers,Eagles,12,40,0,-28,52,1.0,33
2020,13,Chiefs,Ravens,13,16,0,-3,29,0.0,52
2020,13,Steelers,Patriots,13,34,0,-21,47,1.0,38
2020,13,Bears,Eagles,10,14,0,-4,24,2.0,37
2020,14,Packers,Patriots,27,31,0,-4,58,2.0,29
2020,14,Patriots,Packers,27,30,0,-3,57,1.0,48
2020,14,Eagles,Cowboys,11,26,0,-15,37,2.0,35
2020,14,Chiefs,Ravens,44,21,1,23,65,1.0,53
2020,14,Patriots,Steelers,45,18,1,27,63,2.0,49
2020,14,Cowboys,Steelers,39,18,1,21,57,2.0,35
2020,14,49ers,Cowboys,27,44,0,-17,71,1.0,34
2020,14,Bills,Packers,40,17,1,23,57,2.0,37
2020,15,Steelers,Packers,23,41,0,-18,64,0.0,39
2020,15,Eagles,49ers,36,42,0,-6,78,1.0,36
2020,15,Ravens,Packers,44,42,1,2,86,2.0,38
2020,15,Cowboys,Packers,13,20,0,-7,33,1.0,36
2020,15,49ers,Packers,40,34,1,6,74,1.0,35
2020,15,Cowboys,Patriots,10,13,0,-3,23,1.0,37
2020,15,Eagles,49ers,34,13,1,21,47,1.0,37
2020,15,Steelers,Cowboys,38,29,1,9,67,1.0,40
2020,16,Steelers,Bills,10,23,0,-13,33,1.0,41
2020,16,Bears,Patriots,42,36,1,6,78,2.0,38
2020,16,Eagles,Ravens,40,39,1,1,79,2.0,38
2020,16,Patriots,Bills,37,43,0,-6,80,1.0,50
2020,16,Patriots,Bills,12,22,0,-10,34,1.0,51
2020,16,Eagles,Chiefs,12,45,0,-33,57,2.0,39
2020,16,Cowboys,Bears,31,34,0,-3,65,0.0,38
2020,16,Bears,49ers,37,31,1,6,68,2.0,39
2020,17,49ers,Patriots,45,24,1,21,69,2.0,36
2020,17,Steelers,Chiefs,35,12,1,23,47,2.0,42
2020,17,Steelers,49ers,15,37,0,-22,52,1.0,43
2020,17,Eagles,Patriots,22,30,0,-8,52,1.0,40
2020,17,Bears,Patriots,27,40,0,-13,67,2.0,40
2020,17,Patriots,Bears,45,28,1,17,73,1.0,52
2020,17,Packers,Patriots,11,22,0,-11,33,1.0,30
2020,17,Patriots,Cowboys,42,10,1,32,52,2.0,53
2021,1,Eagles,Steelers,11,14,0,-3,25,0.0,41
2021,1,Packers,Ravens,32,22,1,10,54,1.0,31
2021,1,Cowboys,Ravens,32,41,0,-9,73,0.0,39
2021,1,Cowboys,49ers,34,31,1,3,65,1.0,40
2021,1,Bears,Steelers,11,23,0,-12,34,1.0,41
2021,1,Ravens,Packers,35,38,0,-3,73,2.0,39
2021,1,Chiefs,Packers,16,12,1,4,28,2.0,54
2021,1,Steelers,Packers,40,28,1,12,68,2.0,44
2021,2,Packers,Ravens,42,27,1,15,69,2.0,32
2021,2,Packers,Patriots,25,30,0,-5,55,2.0,33
2021,2,49ers,Eagles,28,22,1,6,50,3.0,37
2021,2,Bears,49ers,17,40,0,-23,57,0.0,42
2021,2,Packers,Steelers,11,25,0,-14,36,1.0,34
2021,2,Cowboys,Eagles,23,40,0,-17,63,1.0,41
2021,2,Steelers,Patriots,16,28,0,-12,44,1.0,45
2021,2,Bills,Chiefs,20,45,0,-25,65,1.0,38
2021,3,Chiefs,Patriots,27,39,0,-12,66,2.0,55
2021,3,Cowboys,Bills,38,18,1,20,56,2.0,42
2021,3,Chiefs,49ers,15,38,0,-23,53,1.0,56
2021,3,Ravens,Bears,20,40,0,-20,60,1.0,40
2021,3,Ravens,Bills,39,38,1,1,77,1.0,41
2021,3,Bills,Steelers,21,36,0,-15,57,1.0,39
2021,3,49ers,Bills,14,27,0,-13,41,2.0,38
2021,3,Cowboys,Steelers,31,34,0,-3,65,1.0,43
2021,4,Chiefs,Eagles,25,19,1,6,44,1.0,57
2021,4,49ers,Packers,30,23,1,7,53,2.0,39
2021,4,Chiefs,Packers,22,12,1,10,34,2.0,58
2021,4,49ers,Ravens,16,25,0,-9,41,1.0,40
2021,4,Packers,Eagles,38,14,1,24,52,1.0,35
2021,4,Patriots,Steelers,16,36,0,-20,52,2.0,54
2021,4,Chiefs,Eagles,30,31,0,-1,61,2.0,59
2021,4,Eagles,Steelers,22,12,1,10,34,1.0,42
2021,5,Ravens,Packers,40,20,1,20,60,2.0,42
2021,5,Eagles,Patriots,37,20,1,17,57,2.0,43
2021,5,49ers,Eagles,21,19,1,2,40,2.0,41
2021,5,Chiefs,Patriots,37,29,1,8,66,2.0,60
2021,5,Bills,Packers,25,44,0,-19,69,0.0,40
2021,5,Packers,Patriots,43,36,1,7,79,2.0,36
2021,5,Cowboys,Bills,34,33,1,1,67,2.0,44
2021,5,Bears,Cowboys,12,34,0,-22,46,0.0,43
2021,6,Bears,Ravens,31,11,1,20,42,1.0,44
2021,6,Cowboys,Patriots,38,11,1,27,49,2.0,45
2021,6,Ravens,Patriots,45,36,1,9,81,3.0,43
2021,6,Packers,Cowboys,44,38,1,6,82,3.0,37
2021,6,Bills,Eagles,22,26,0,-4,48,0.0,41
2021,6,Eagles,Bills,16,28,0,-12,44,2.0,44
2021,6,Patriots,Bills,42,23,1,19,65,2.0,55
2021,6,Packers,Chiefs,12,21,0,-9,33,2.0,38
2021,7,Bears,Steelers,31,27,1,4,58,2.0,45
2021,7,Bears,49ers,42,30,1,12,72,3.0,46
2021,7,Steelers,Bears,28,18,1,10,46,2.0,46
2021,7,Chiefs,Cowboys,35,15,1,20,50,2.0,61
2021,7,Ravens,Eagles,23,26,0,-3,49,2.0,44
2021,7,Ravens,Packers,32,19,1,13,51,2.0,45
2021,7,Eagles,Cowboys,16,36,0,-20,52,1.0,45
2021,7,Eagles,Chiefs,25,25,0,0,50,0.0,46
2021,8,Bills,Bears,20,32,0,-12,52,0.0,42
2021,8,Cowboys,Patriots,38,14,1,24,52,3.0,46
2021,8,Ravens,Packers,33,17,1,16,50,2.0,46
2021,8,Steelers,Bills,18,44,0,-26,62,1.0,47
2021,8,Chiefs,Ravens,28,43,0,-15,71,2.0,62
2021,8,Bills,49ers,28,42,0,-14,70,0.0,43
2021,8,Steelers,Packers,33,14,1,19,47,2.0,48
2021,8,Steelers,49ers,32,28,1,4,60,2.0,49
2021,9,Ravens,Chiefs,19,18,1,1,37,3.0,47
2021,9,49ers,Eagles,22,41,0,-19,63,1.0,42
2021,9,Packers,Bills,17,18,0,-1,35,1.0,39
2021,9,Eagles,Bills,19,29,0,-10,48,0.0,47
2021,9,Cowboys,Eagles,15,16,0,-1,31,2.0,47
2021,9,Ravens,Bills,21,24,0,-3,45,2.0,48
2021,9,Chiefs,Eagles,31,45,0,-14,76,1.0,63
2021,9,Chiefs,Bears,36,44,0,-8,80,0.0,64
2021,10,Bears,Bills,19,25,0,-6,44,2.0,47
2021,10,Packers,Eagles,13,30,0,-17,43,0.0,40
2021,10,Ravens,Packers,44,41,1,3,85,2.0,49
2021,10,Ravens,Bears,10,44,0,-34,54,1.0,50
2021,10,Steelers,Packers,11,17,0,-6,28,2.0,50
2021,10,Eagles,Cowboys,41,38,1,3,79,1.0,48
2021,10,Packers,Steelers,31,22,1,9,53,1.0,41
2021,10,Chiefs,Patriots,45,29,1,16,74,1.0,65
2021,11,Cowboys,Steelers,43,30,1,13,73,2.0,48
2021,11,Bills,Steelers,17,26,0,-9,43,0.0,44
2021,11,Chiefs,Cowboys,42,19,1,23,61,2.0,66
2021,11,Steelers,Patriots,36,16,1,20,52,2.0,51
2021,11,Bears,Packers,40,16,1,24,56,2.0,48
2021,11,Bears,49ers,26,42,0,-16,68,1.0,49
2021,11,Patriots,Bears,13,11,1,2,24,2.0,56
2021,11,Cowboys,Bills,11,40,0,-29,51,1.0,49
2021,12,Chiefs,Cowboys,43,23,1,20,66,3.0,67
2021,12,Ravens,Bears,42,30,1,12,72,2.0,51
2021,12,Eagles,Chiefs,11,38,0,-27,49,1.0,49
2021,12,Chiefs,Cowboys,12,39,0,-27,51,2.0,68
2021,12,Eagles,Ravens,14,40,0,-26,54,1.0,50
2021,12,Eagles,49ers,41,29,1,12,70,1.0,51
2021,12,Cowboys,49ers,42,44,0,-2,86,1.0,50
2021,12,Patriots,Packers,15,44,0,-29,59,2.0,57
2021,13,Cowboys,Chiefs,24,34,0,-10,58,0.0,51
2021,13,Bears,Chiefs,32,21,1,11,53,2.0,50
2021,13,Steelers,Chiefs,45,24,1,21,69,2.0,52
2021,13,Cowboys,Patriots,42,30,1,12,72,1.0,52
2021,13,Bears,Chiefs,25,42,0,-17,67,1.0,51
2021,13,Patriots,49ers,15,22,0,-7,37,1.0,58
2021,13,Packers,Bears,30,18,1,12,48,2.0,42
2021,13,Steelers,Bears,12,34,0,-22,46,2.0,53
2021,14,Cowboys,Ravens,24,39,0,-15,63,1.0,53
2021,14,Chiefs,Eagles,29,41,0,-12,70,1.0,69
2021,14,Eagles,Chiefs,13,14,0,-1,27,1.0,52
2021,14,Chiefs,Cowboys,31,30,1,1,61,1.0,70
2021,14,Bills,Eagles,12,19,0,-7,31,0.0,45
2021,14,Packers,Eagles,32,43,0,-11,75,2.0,43
2021,14,Packers,Bears,39,33,1,6,72,2.0,44
2021,14,Patriots,Steelers,26,37,0,-11,63,0.0,59
2021,15,Bears,Chiefs,31,27,1,4,58,2.0,52
2021,15,Bears,Packers,22,14,1,8,36,2.0,53
2021,15,49ers,Packers,16,10,1,6,26,2.0,43
2021,15,49ers,Packers,34,20,1,14,54,2.0,44
2021,15,Chiefs,Bears,16,36,0,-20,52,1.0,71
2021,15,Packers,Patriots,29,35,0,-6,64,1.0,45
2021,15,49ers,Ravens,21,35,0,-14,56,2.0,45
2021,15,Cowboys,49ers,16,13,1,3,29,2.0,54
2021,16,Eagles,Patriots,23,32,0,-9,55,1.0,53
2021,16,Steelers,Ravens,21,12,1,9,33,2.0,54
2021,16,Packers,Ravens,39,15,1,24,54,2.0,46
2021,16,Bears,Steelers,34,45,0,-11,79,2.0,54
2021,16,Ravens,Packers,38,40,0,-2,78,1.0,52
2021,16,Chiefs,49ers,42,19,1,23,61,2.0,72
2021,16,Packers,Ravens,38,38,0,0,76,1.0,47
2021,16,49ers,Bills,35,37,0,-2,72,1.0,46
2021,17,Chiefs,Ravens,10,33,0,-23,43,1.0,73
2021,17,49ers,Steelers,25,39,0,-14,64,0.0,47
2021,17,Cowboys,Patriots,32,45,0,-13,77,1.0,55
2021,17,49ers,Patriots,40,21,1,19,61,1.0,48
2021,17,Patriots,Ravens,42,39,1,3,81,1.0,60
2021,17,Eagles,Bears,14,44,0,-30,58,0.0,54
2021,17,Cowboys,Bills,11,40,0,-29,51,1.0,56
2021,17,Ravens,Bills,36,22,1,14,58,2.0,53
2022,1,Packers,Chiefs,34,33,1,1,67,2.0,48
2022,1,49ers,Eagles,24,30,0,-6,54,1.0,49
2022,1,Bills,49ers,37,30,1,7,67,1.0,46
2022,1,Eagles,Chiefs,19,11,1,8,30,1.0,55
2022,1,Ravens,Packers,44,16,1,28,60,2.0,54
2022,1,Bears,49ers,19,10,1,9,29,2.0,55
2022,1,Patriots,Chiefs,23,43,0,-20,66,1.0,61
2022,1,Eagles,Bears,43,43,0,0,86,1.0,56
2022,2,Bills,Steelers,20,14,1,6,34,2.0,47
2022,2,Ravens,49ers,22,10,1,12,32,3.0,55
2022,2,Ravens,Cowboys,38,40,0,-2,78,2.0,56
2022,2,Steelers,Chiefs,38,31,1,7,69,2.0,55
2022,2,Bears,Chiefs,34,22,1,12,56,2.0,56
2022,2,Chiefs,Steelers,12,23,0,-11,35,1.0,74
2022,2,Cowboys,Chiefs,22,28,0,-6,50,0.0,57
2022,2,Ravens,Steelers,36,13,1,23,49,2.0,57
2022,3,49ers,Chiefs,44,29,1,15,73,2.0,50
2022,3,49ers,Patriots,45,26,1,19,71,2.0,51
2022,3,49ers,Patriots,37,38,0,-1,75,2.0,52
2022,3,Ravens,49ers,17,25,0,-8,42,1.0,58
2022,3,Ravens,49ers,45,17,1,28,62,2.0,59
2022,3,Packers,Chiefs,10,15,0,-5,25,1.0,49
2022,3,Bills,Ravens,11,29,0,-18,40,2.0,48
2022,3,Steelers,Eagles,33,42,0,-9,75,2.0,56
2022,4,Bills,Cowboys,39,33,1,6,72,2.0,49
2022,4,Cowboys,Steelers,28,35,0,-7,63,0.0,58
2022,4,Packers,Patriots,19,24,0,-5,43,1.0,50
2022,4,Steelers,Packers,13,12,1,1,25,2.0,57
2022,4,Ravens,Steelers,32,15,1,17,47,2.0,60
2022,4,49ers,Eagles,15,41,0,-26,56,1.0,53
2022,4,49ers,Bears,14,35,0,-21,49,0.0,54
2022,4,Steelers,Ravens,31,33,0,-2,64,1.0,58
2022,5,Bears,Bills,25,17,1,8,42,3.0,57
2022,5,Steelers,Bills,39,11,1,28,50,2.0,59
2022,5,Eagles,Packers,36,23,1,13,59,2.0,57
2022,5,Packers,Bears,24,35,0,-11,59,0.0,51
2022,5,Ravens,Chiefs,39,30,1,9,69,3.0,61
2022,5,Bills,Bears,11,15,0,-4,26,1.0,50
2022,5,49ers,Patriots,44,16,1,28,60,1.0,55
2022,5,Packers,Chiefs,21,31,0,-10,52,0.0,52
2022,6,Patriots,Steelers,12,32,0,-20,44,1.0,62
2022,6,49ers,Bears,45,37,1,8,82,2.0,56
2022,6,49ers,Bills,40,15,1,25,55,3.0,57
2022,6,Cowboys,Bills,42,43,0,-1,85,0.0,59
2022,6,Bears,Chiefs,24,30,0,-6,54,2.0,58
2022,6,Eagles,Chiefs,16,33,0,-17,49,1.0,58
2022,6,Ravens,Chiefs,38,45,0,-7,83,2.0,62
2022,6,Bills,49ers,38,35,1,3,73,2.0,51
2022,7,Eagles,Bills,36,35,1,1,71,2.0,59
2022,7,Packers,Eagles,40,10,1,30,50,1.0,53
2022,7,49ers,Packers,29,38,0,-9,67,2.0,58
2022,7,Eagles,Patriots,35,18,1,17,53,2.0,60
2022,7,Chiefs,Bears,27,41,0,-14,68,0.0,75
2022,7,Cowboys,Patriots,25,23,1,2,48,1.0,60
2022,7,Patriots,Bears,22,20,1,2,42,1.0,63
2022,7,Steelers,Cowboys,41,42,0,-1,83,1.0,60
2022,8,Steelers,Cowboys,27,21,1,6,48,2.0,61
2022,8,Ravens,49ers,17,11,1,6,28,2.0,63
2022,8,Cowboys,Eagles,41,41,0,0,82,1.0,61
2022,8,Bills,Packers,45,11,1,34,56,2.0,52
2022,8,Patriots,Packers,12,45,0,-33,57,1.0,64
2022,8,Bears,Bills,41,10,1,31,51,2.0,59
2022,8,Bills,Packers,28,20,1,8,48,3.0,53
2022,8,Chiefs,49ers,37,21,1,16,58,1.0,76
2022,9,49ers,Patriots,31,11,1,20,42,2.0,59
2022,9,Steelers,Packers,33,15,1,18,48,2.0,62
2022,9,Ravens,Chiefs,11,17,0,-6,28,1.0,64
2022,9,Chiefs,49ers,44,20,1,24,64,2.0,77
2022,9,Chiefs,Ravens,41,17,1,24,58,3.0,78
2022,9,Eagles,49ers,37,22,1,15,59,3.0,61
2022,9,Patriots,Packers,37,44,0,-7,81,1.0,65
2022,9,Packers,Patriots,14,36,0,-22,50,1.0,54
2022,10,Bears,49ers,26,41,0,-15,67,1.0,60
2022,10,Patriots,Cowboys,17,44,0,-27,61,0.0,66
2022,10,Ravens,Bears,12,40,0,-28,52,1.0,65
2022,10,Bears,49ers,27,21,1,6,48,2.0,61
2022,10,Steelers,Packers,18,32,0,-14,50,2.0,63
2022,10,Cowboys,49ers,30,16,1,14,46,2.0,62
2022,10,Cowboys,Bears,33,14,1,19,47,2.0,63
2022,10,Chiefs,Ravens,41,39,1,2,80,3.0,79
2022,11,Bills,Ravens,36,18,1,18,54,3.0,54
2022,11,Chiefs,49ers,29,32,0,-3,61,2.0,80
2022,11,Chiefs,Eagles,17,29,0,-12,46,1.0,81
2022,11,Patriots,Packers,27,34,0,-7,61,0.0,67
2022,11,Cowboys,Packers,34,23,1,11,57,3.0,64
2022,11,Chiefs,Packers,32,11,1,21,43,1.0,82
2022,11,Steelers,Ravens,32,41,0,-9,73,1.0,64
2022,11,Packers,Eagles,13,36,0,-23,49,1.0,55
2022,12,Eagles,49ers,45,14,1,31,59,3.0,62
2022,12,Chiefs,Packers,34,28,1,6,62,2.0,83
2022,12,Cowboys,Bears,13,20,0,-7,33,2.0,65
2022,12,49ers,Eagles,44,39,1,5,83,2.0,60
2022,12,Bears,Steelers,40,23,1,17,63,2.0,62
2022,12,Patriots,Bears,34,38,0,-4,72,0.0,68
2022,12,Patriots,Steelers,45,24,1,21,69,1.0,69
2022,12,49ers,Eagles,13,30,0,-17,43,2.0,61
2022,13,Bills,Chiefs,33,19,1,14,52,3.0,55
2022,13,Patriots,Chiefs,23,35,0,-12,58,1.0,70
2022,13,Cowboys,Steelers,42,20,1,22,62,2.0,66
2022,13,Patriots,Chiefs,10,34,0,-24,44,1.0,71
2022,13,49ers,Patriots,33,31,1,2,64,2.0,62
2022,13,Ravens,Steelers,38,42,0,-4,80,0.0,66
2022,13,Packers,Patriots,14,38,0,-24,52,0.0,56
2022,13,Bears,49ers,36,10,1,26,46,3.0,63
2022,14,Cowboys,Chiefs,36,22,1,14,58,2.0,67
2022,14,Eagles,Bills,28,27,1,1,55,3.0,63
2022,14,Packers,Eagles,32,26,1,6,58,1.0,57
2022,14,Bears,Bills,32,24,1,8,56,3.0,64
2022,14,Cowboys,49ers,34,30,1,4,64,3.0,68
2022,14,Bills,Chiefs,13,17,0,-4,30,2.0,56
2022,14,49ers,Ravens,24,23,1,1,47,2.0,63
2022,14,Patriots,Eagles,17,35,0,-18,52,0.0,72
2022,15,Cowboys,49ers,19,30,0,-11,49,2.0,69
2022,15,Steelers,Bears,10,34,0,-24,44,0.0,65
2022,15,Patriots,49ers,14,26,0,-12,40,0.0,73
2022,15,Bears,Bills,12,38,0,-26,50,2.0,65
2022,15,Cowboys,Bears,41,38,1,3,79,2.0,70
2022,15,Ravens,Bills,17,41,0,-24,58,0.0,67
2022,15,Patriots,49ers,29,27,1,2,56,1.0,74
2022,15,Bears,Steelers,12,29,0,-17,41,1.0,66
2022,16,Patriots,Steelers,11,35,0,-24,46,1.0,75
2022,16,Patriots,Steelers,26,27,0,-1,53,1.0,76
2022,16,Bears,Chiefs,17,10,1,7,27,1.0,67
2022,16,Chiefs,Eagles,16,28,0,-12,44,2.0,84
2022,16,49ers,Patriots,40,39,1,1,79,3.0,64
2022,16,Steelers,Chiefs,38,14,1,24,52,1.0,66
2022,16,Bears,Packers,36,34,1,2,70,2.0,68
2022,16,Bills,Steelers,16,23,0,-7,39,1.0,57
2022,17,Bears,Chiefs,31,27,1,4,58,3.0,69
2022,17,Ravens,Eagles,45,45,0,0,90,0.0,68
2022,17,Steelers,Patriots,44,11,1,33,55,2.0,67
2022,17,49ers,Steelers,30,42,0,-12,72,2.0,65
2022,17,Eagles,Chiefs,21,21,0,0,42,2.0,64
2022,17,Patriots,Cowboys,40,15,1,25,55,1.0,77
2022,17,Cowboys,Ravens,10,45,0,-35,55,1.0,71
2022,17,Cowboys,49ers,20,42,0,-22,62,1.0,72
2023,1,Packers,Bears,19,34,0,-15,53,1.0,58
2023,1,Bears,Eagles,21,45,0,-24,66,2.0,70
2023,1,Bills,Cowboys,12,23,0,-11,35,0.0,58
2023,1,Bears,Patriots,13,30,0,-17,43,1.0,71
2023,1,Chiefs,Packers,27,20,1,7,47,2.0,85
2023,1,Cowboys,Bills,15,22,0,-7,37,0.0,73
2023,1,Packers,Eagles,35,26,1,9,61,2.0,59
2023,1,49ers,Eagles,33,26,1,7,59,2.0,66
2023,2,Steelers,49ers,21,29,0,-8,50,2.0,68
2023,2,Chiefs,Eagles,45,34,1,11,79,2.0,86
2023,2,Eagles,Bears,43,18,1,25,61,2.0,65
2023,2,Cowboys,49ers,26,15,1,11,41,1.0,74
2023,2,Packers,Bears,30,33,0,-3,63,1.0,60
2023,2,Bills,Cowboys,34,42,0,-8,76,0.0,59
2023,2,Steelers,49ers,38,34,1,4,72,2.0,69
2023,2,Cowboys,Bills,23,37,0,-14,60,1.0,75
2023,3,Bills,Patriots,37,16,1,21,53,1.0,60
2023,3,Steelers,Bills,13,14,0,-1,27,1.0,70
2023,3,Eagles,Bills,38,17,1,21,55,2.0,66
2023,3,Cowboys,Ravens,14,30,0,-16,44,1.0,76
2023,3,Eagles,49ers,44,19,1,25,63,3.0,67
2023,3,Steelers,Chiefs,32,43,0,-11,75,1.0,71
2023,3,Cowboys,Ravens,14,11,1,3,25,1.0,77
2023,3,Bills,Ravens,11,19,0,-8,30,1.0,61
2023,4,Chiefs,Packers,38,21,1,17,59,3.0,87
2023,4,49ers,Cowboys,44,32,1,12,76,2.0,67
2023,4,Packers,Eagles,33,15,1,18,48,2.0,61
2023,4,Bears,Ravens,45,38,1,7,83,1.0,72
2023,4,49ers,Packers,12,25,0,-13,37,2.0,68
2023,4,49ers,Patriots,11,27,0,-16,38,1.0,69
2023,4,49ers,Packers,12,34,0,-22,46,0.0,70
2023,4,Patriots,Bills,26,35,0,-9,61,1.0,78
2023,5,Bears,Patriots,35,37,0,-2,72,1.0,73
2023,5,Steelers,Eagles,18,40,0,-22,58,0.0,72
2023,5,Cowboys,Bears,13,14,0,-1,27,1.0,78
2023,5,Ravens,Cowboys,16,33,0,-17,49,0.0,69
2023,5,Bears,Eagles,11,10,1,1,21,2.0,74
2023,5,Cowboys,Steelers,29,13,1,16,42,2.0,79
2023,5,Eagles,Cowboys,27,42,0,-15,69,2.0,68
2023,5,Cowboys,Steelers,12,21,0,-9,33,1.0,80
2023,6,Ravens,Patriots,30,25,1,5,55,1.0,70
2023,6,Cowboys,Packers,23,18,1,5,41,2.0,81
2023,6,Steelers,Ravens,20,15,1,5,35,1.0,73
2023,6,Steelers,Chiefs,36,33,1,3,69,2.0,74
2023,6,Packers,Eagles,12,14,0,-2,26,1.0,62
2023,6,Packers,Chiefs,18,12,1,6,30,2.0,63
2023,6,Ravens,Eagles,33,35,0,-2,68,1.0,71
2023,6,Patriots,Cowboys,30,36,0,-6,66,1.0,79
2023,7,Bills,Ravens,24,24,0,0,48,1.0,62
2023,7,Cowboys,49ers,23,39,0,-16,62,1.0,82
2023,7,Patriots,Steelers,33,13,1,20,46,1.0,80
2023,7,Steelers,Bills,32,29,1,3,61,3.0,75
2023,7,Bills,Patriots,42,26,1,16,68,1.0,63
2023,7,Eagles,Packers,27,37,0,-10,64,1.0,69
2023,7,49ers,Eagles,44,43,1,1,87,1.0,71
2023,7,Bears,Ravens,17,43,0,-26,60,1.0,75
2023,8,Steelers,49ers,28,44,0,-16,72,2.0,76
2023,8,Cowboys,Steelers,27,15,1,12,42,2.0,83
2023,8,Bills,Packers,16,34,0,-18,50,1.0,64
2023,8,49ers,Steelers,41,15,1,26,56,2.0,72
2023,8,Steelers,Bills,45,38,1,7,83,2.0,77
2023,8,Ravens,49ers,40,25,1,15,65,2.0,72
2023,8,Bills,Eagles,38,29,1,9,67,2.0,65
2023,8,Bills,Patriots,43,40,1,3,83,2.0,66
2023,9,Packers,Cowboys,27,15,1,12,42,2.0,64
2023,9,Bills,Cowboys,13,28,0,-15,41,2.0,67
2023,9,Bills,Eagles,45,37,1,8,82,2.0,68
2023,9,Packers,Chiefs,13,26,0,-13,39,2.0,65
2023,9,Cowboys,Chiefs,12,38,0,-26,50,1.0,84
2023,9,Chiefs,Bills,33,11,1,22,44,3.0,88
2023,9,Chiefs,Patriots,10,15,0,-5,25,2.0,89
2023,9,Bears,Eagles,41,21,1,20,62,2.0,76
2023,10,Bears,Chiefs,13,10,1,3,23,2.0,77
2023,10,Packers,Chiefs,11,30,0,-19,41,1.0,66
2023,10,Eagles,49ers,45,44,1,1,89,1.0,70
2023,10,Ravens,Bears,44,38,1,6,82,2.0,73
2023,10,49ers,Bills,19,29,0,-10,48,2.0,73
2023,10,Eagles,Bills,39,32,1,7,71,2.0,71
2023,10,Chiefs,Cowboys,22,34,0,-12,56,1.0,90
2023,10,Eagles,Bears,20,41,0,-21,61,2.0,72
2023,11,Eagles,Steelers,16,13,1,3,29,2.0,73
2023,11,Chiefs,Bears,22,43,0,-21,65,0.0,91
2023,11,Bills,Cowboys,12,27,0,-15,39,1.0,69
2023,11,Packers,Eagles,36,12,1,24,48,1.0,67
2023,11,Steelers,Eagles,38,32,1,6,70,2.0,78
2023,11,Packers,Eagles,44,33,1,11,77,2.0,68
2023,11,Bears,Cowboys,24,11,1,13,35,3.0,78
2023,11,Cowboys,Ravens,45,24,1,21,69,2.0,85
2023,12,Cowboys,Ravens,27,28,0,-1,55,1.0,86
2023,12,Eagles,Bears,12,21,0,-9,33,1.0,74
2023,12,Chiefs,Cowboys,21,16,1,5,37,1.0,92
2023,12,Ravens,Eagles,21,18,1,3,39,3.0,74
2023,12,49ers,Eagles,22,44,0,-22,66,1.0,74
2023,12,Cowboys,Packers,26,24,1,2,50,2.0,87
2023,12,Chiefs,Cowboys,36,22,1,14,58,2.0,93
2023,12,Chiefs,49ers,15,26,0,-11,41,2.0,94
2023,13,Steelers,Packers,22,35,0,-13,57,2.0,79
2023,13,Cowboys,Bills,14,41,0,-27,55,1.0,88
2023,13,Bears,Patriots,34,29,1,5,63,3.0,79
2023,13,Bills,Bears,36,35,1,1,71,2.0,70
2023,13,Bills,Ravens,43,29,1,14,72,2.0,71
2023,13,Cowboys,Ravens,18,40,0,-22,58,1.0,89
2023,13,Packers,Chiefs,45,11,1,34,56,3.0,69
2023,13,Cowboys,49ers,27,35,0,-8,62,0.0,90
2023,14,Ravens,Eagles,35,39,0,-4,74,2.0,75
2023,14,49ers,Steelers,23,19,1,4,42,1.0,75
2023,14,Bears,Chiefs,24,42,0,-18,66,2.0,80
2023,14,Ravens,Cowboys,23,10,1,13,33,2.0,76
2023,14,Packers,Cowboys,41,43,0,-2,84,2.0,70
2023,14,Cowboys,49ers,42,40,1,2,82,1.0,91
2023,14,49ers,Packers,16,27,0,-11,43,1.0,76
2023,14,Bills,Packers,38,35,1,3,73,3.0,72
2023,15,Steelers,Bills,14,17,0,-3,31,1.0,80
2023,15,Packers,Bears,43,23,1,20,66,2.0,71
2023,15,Ravens,Steelers,18,26,0,-8,44,1.0,77
2023,15,Steelers,Bills,17,27,0,-10,44,0.0,81
2023,15,Eagles,Cowboys,35,12,1,23,47,2.0,75
2023,15,Eagles,Bills,15,16,0,-1,31,1.0,76
2023,15,Cowboys,Bears,15,35,0,-20,50,1.0,92
2023,15,Bills,Chiefs,13,19,0,-6,32,2.0,73
2023,16,Cowboys,Ravens,15,41,0,-26,56,1.0,93
2023,16,Eagles,Cowboys,13,45,0,-32,58,1.0,77
2023,16,Steelers,Chiefs,11,44,0,-33,55,0.0,82
2023,16,Bears,Chiefs,19,33,0,-14,52,1.0,81
2023,16,Bears,49ers,36,39,0,-3,75,0.0,82
2023,16,Steelers,Ravens,42,43,0,-1,85,0.0,83
2023,16,Ravens,Bills,22,22,0,0,44,1.0,78
2023,16,Cowboys,Packers,21,40,0,-19,61,0.0,94
2023,17,Eagles,Steelers,33,43,0,-10,76,0.0,78
2023,17,Packers,Bills,35,40,0,-5,75,1.0,72
2023,17,Eagles,Patriots,21,45,0,-24,66,0.0,79
2023,17,Packers,Bills,12,35,0,-23,47,1.0,73
2023,17,Cowboys,Patriots,35,45,0,-10,80,0.0,95
2023,17,Ravens,Steelers,44,29,1,15,73,1.0,79
2023,17,Ravens,Steelers,17,13,1,4,30,2.0,80
2023,17,Bills,Steelers,15,18,0,-3,33,1.0,74
2024,1,Packers,Bears,19,21,0,-2,40,0.0,74
2024,1,Patriots,Ravens,20,13,1,7,33,2.0,81
2024,1,Bears,Packers,19,12,1,7,31,1.0,83
2024,1,Chiefs,Packers,25,23,1,2,48,2.0,95
2024,1,Packers,Steelers,23,34,0,-11,57,0.0,75
2024,1,Chiefs,Packers,45,12,1,33,57,2.0,96
2024,1,Steelers,49ers,28,37,0,-9,65,0.0,84
2024,1,Bears,Packers,33,39,0,-6,72,1.0,84
2024,2,Chiefs,Packers,17,41,0,-24,58,2.0,97
2024,2,Eagles,Patriots,19,28,0,-9,47,0.0,80
2024,2,Bills,Cowboys,32,28,1,4,60,1.0,75
2024,2,Bears,Eagles,12,21,0,-9,33,1.0,85
2024,2,Bears,Packers,14,43,0,-29,57,0.0,86
2024,2,Chiefs,Steelers,14,44,0,-30,58,1.0,98
2024,2,Ravens,49ers,43,37,1,6,80,3.0,81
2024,2,Eagles,Patriots,32,26,1,6,58,1.0,81
2024,3,Chiefs,Bears,39,12,1,27,51,1.0,99
2024,3,49ers,Ravens,13,21,0,-8,34,1.0,77
2024,3,Cowboys,Packers,29,17,1,12,46,1.0,96
2024,3,Eagles,Patriots,42,43,0,-1,85,1.0,82
2024,3,Eagles,Bills,30,17,1,13,47,2.0,83
2024,3,Chiefs,Patriots,29,11,1,18,40,2.0,100
2024,3,49ers,Chiefs,38,40,0,-2,78,0.0,78
2024,3,Packers,Eagles,44,41,1,3,85,1.0,76
2024,4,Patriots,Chiefs,27,28,0,-1,55,2.0,82
2024,4,Bills,Eagles,19,10,1,9,29,2.0,76
2024,4,Eagles,Steelers,35,26,1,9,61,2.0,84
2024,4,Steelers,Chiefs,19,33,0,-14,52,0.0,85
2024,4,Eagles,Bills,13,31,0,-18,44,2.0,85
2024,4,Eagles,Bills,26,40,0,-14,66,1.0,86
2024,4,Ravens,Bills,29,33,0,-4,62,2.0,82
2024,4,Bears,Ravens,37,18,1,19,55,1.0,87
2024,5,Bears,Ravens,10,28,0,-18,38,1.0,88
2024,5,Bears,Cowboys,34,20,1,14,54,2.0,89
2024,5,Steelers,Bills,40,38,1,2,78,1.0,86
2024,5,Bills,49ers,28,15,1,13,43,3.0,77
2024,5,Steelers,Ravens,22,19,1,3,41,2.0,87
2024,5,Packers,Steelers,38,37,1,1,75,2.0,77
2024,5,Packers,Cowboys,27,14,1,13,41,3.0,78
2024,5,Chiefs,Patriots,38,22,1,16,60,3.0,101
2024,6,Chiefs,Packers,17,19,0,-2,36,2.0,102
2024,6,Steelers,Packers,22,24,0,-2,46,2.0,88
2024,6,Cowboys,Packers,37,28,1,9,65,2.0,97
2024,6,Eagles,Bears,40,18,1,22,58,1.0,87
2024,6,Patriots,49ers,24,14,1,10,38,2.0,83
2024,6,Steelers,Bills,11,38,0,-27,49,1.0,89
2024,6,49ers,Cowboys,34,15,1,19,49,1.0,79
2024,6,Bears,49ers,24,18,1,6,42,2.0,90
2024,7,Bears,Patriots,44,35,1,9,79,3.0,91
2024,7,Steelers,Patriots,21,14,1,7,35,1.0,90
2024,7,Steelers,Bears,25,19,1,6,44,2.0,91
2024,7,Eagles,Packers,25,13,1,12,38,2.0,88
2024,7,Bills,Bears,39,21,1,18,60,3.0,78
2024,7,49ers,Packers,22,40,0,-18,62,1.0,80
2024,7,Ravens,Bills,30,38,0,-8,68,1.0,83
2024,7,49ers,Eagles,27,18,1,9,45,2.0,81
2024,8,49ers,Cowboys,13,44,0,-31,57,1.0,82
2024,8,Cowboys,49ers,15,19,0,-4,34,2.0,98
2024,8,Ravens,Eagles,39,15,1,24,54,1.0,84
2024,8,Bears,Chiefs,37,16,1,21,53,3.0,92
2024,8,Packers,Ravens,36,40,0,-4,76,2.0,79
2024,8,Cowboys,Eagles,29,34,0,-5,63,1.0,99
2024,8,Bears,Packers,37,10,1,27,47,3.0,93
2024,8,Cowboys,Bills,45,18,1,27,63,1.0,100
2024,9,Patriots,49ers,21,18,1,3,39,2.0,84
2024,9,Ravens,Eagles,39,44,0,-5,83,1.0,85
2024,9,Patriots,Cowboys,43,44,0,-1,87,2.0,85
2024,9,Packers,49ers,34,44,0,-10,78,1.0,80
2024,9,Cowboys,Steelers,24,20,1,4,44,2.0,101
2024,9,Patriots,Bears,10,31,0,-21,41,1.0,86
2024,9,Cowboys,49ers,33,15,1,18,48,3.0,102
2024,9,Packers,Bills,10,29,0,-19,39,0.0,81
2024,10,Packers,Eagles,36,14,1,22,50,1.0,82
2024,10,Ravens,Chiefs,39,36,1,3,75,2.0,86
2024,10,Patriots,Bears,33,19,1,14,52,1.0,87
2024,10,Chiefs,Eagles,21,35,0,-14,56,1.0,103
2024,10,Bears,Ravens,31,11,1,20,42,3.0,94
2024,10,Bears,Steelers,18,21,0,-3,39,2.0,95
2024,10,Chiefs,Ravens,42,32,1,10,74,1.0,104
2024,10,49ers,Bills,12,41,0,-29,53,1.0,83
2024,11,Ravens,Eagles,20,27,0,-7,47,1.0,87
2024,11,49ers,Packers,15,21,0,-6,36,0.0,84
2024,11,Bears,Patriots,36,28,1,8,64,2.0,96
2024,11,Ravens,Patriots,22,27,0,-5,49,1.0,88
2024,11,Cowboys,Packers,20,20,0,0,40,2.0,103
2024,11,Cowboys,49ers,34,44,0,-10,78,1.0,104
2024,11,Eagles,Packers,14,16,0,-2,30,2.0,89
2024,11,Steelers,Chiefs,21,27,0,-6,48,2.0,92
2024,12,49ers,Chiefs,41,12,1,29,53,1.0,85
2024,12,49ers,Chiefs,10,33,0,-23,43,1.0,86
2024,12,Steelers,Cowboys,37,20,1,17,57,2.0,93
2024,12,Ravens,49ers,20,35,0,-15,55,0.0,89
2024,12,Bills,Bears,21,15,1,6,36,3.0,79
2024,12,49ers,Steelers,33,13,1,20,46,2.0,87
2024,12,Chiefs,Ravens,40,28,1,12,68,2.0,105
2024,12,Patriots,Packers,12,29,0,-17,41,1.0,88
2024,13,49ers,Packers,18,41,0,-23,59,1.0,88
2024,13,Ravens,Cowboys,33,36,0,-3,69,0.0,90
2024,13,Steelers,Bills,10,35,0,-25,45,1.0,94
2024,13,49ers,Bills,21,23,0,-2,44,1.0,89
2024,13,Bills,Ravens,34,14,1,20,48,3.0,80
2024,13,Patriots,Ravens,27,19,1,8,46,2.0,89
2024,13,Bears,Bills,15,25,0,-10,40,1.0,97
2024,13,Bears,Patriots,40,15,1,25,55,2.0,98
2024,14,Cowboys,Chiefs,25,28,0,-3,53,0.0,105
2024,14,Bills,Packers,12,28,0,-16,40,2.0,81
2024,14,49ers,Ravens,38,17,1,21,55,1.0,90
2024,14,Bears,Steelers,35,33,1,2,68,2.0,99
2024,14,Bills,Packers,37,30,1,7,67,2.0,82
2024,14,Chiefs,Patriots,44,45,0,-1,89,2.0,106
2024,14,Eagles,Steelers,37,13,1,24,50,2.0,90
2024,14,Eagles,Ravens,35,31,1,4,66,2.0,91
2024,15,Packers,49ers,16,32,0,-16,48,1.0,83
2024,15,Cowboys,49ers,11,35,0,-24,46,0.0,106
2024,15,Cowboys,Steelers,39,31,1,8,70,1.0,107
2024,15,Steelers,Cowboys,25,41,0,-16,66,1.0,95
2024,15,Steelers,Cowboys,38,40,0,-2,78,0.0,96
2024,15,Patriots,49ers,25,36,0,-11,61,1.0,90
2024,15,Ravens,Eagles,14,17,0,-3,31,0.0,91
2024,15,Packers,Bills,40,25,1,15,65,2.0,84
2024,16,Bills,Eagles,18,18,0,0,36,1.0,83
2024,16,Patriots,Chiefs,43,28,1,15,71,2.0,91
2024,16,Bears,Steelers,10,22,0,-12,32,2.0,100
2024,16,Patriots,Bills,24,18,1,6,42,2.0,92
2024,16,Ravens,Chiefs,18,26,0,-8,44,0.0,92
2024,16,Eagles,49ers,41,26,1,15,67,3.0,92
2024,16,Eagles,Cowboys,20,26,0,-6,46,2.0,93
2024,16,Chiefs,Steelers,41,16,1,25,57,2.0,107
2024,17,Patriots,Cowboys,35,13,1,22,48,3.0,93
2024,17,Bills,Packers,11,37,0,-26,48,1.0,84
2024,17,Bears,Steelers,30,11,1,19,41,2.0,101
2024,17,Patriots,Steelers,41,43,0,-2,84,2.0,94
2024,17,Steelers,Patriots,17,12,1,5,29,1.0,97
2024,17,Chiefs,Bills,34,14,1,20,48,2.0,108
2024,17,49ers,Bills,36,13,1,23,49,2.0,91
2024,17,Patriots,Steelers,40,44,0,-4,84,1.0,95
